............W....... 
............W....... 
.****..W....W***.... 
W*WW*..W....W*W*.... 
S*"W***WWWWwW*W****E 
W"W"W.******W*W..... 
."""W......*W*W..... 
."""W......***W..... 
.""""W........W..... 
."""""W.......W..... 
